11111111111111111111111111111111111111111111111111111
1EPC0000000000000000111111110000000000000000000000001
100C00000000C0000000CCCCCCCC0000000000000000000000001
11111111111111111111111111111111111111111111111111111
