111111111111111111111111111111111111111111111111111111111111111111111111111111111111111111111111111111111111111111111
1P000011E000000000000000000000000000000000000000000000000000000000000000000000000000000000000000000000000000000000001
100000110000000000000000000000000000000000000000000000000000000000000000000000000000000000000000000000000000000000001
100000110000000000000000000000000000000000000000000000000000000000000000000000000000000000000000000000000000000000001
10000011000X000000000000000000000000000000000000000000000000000000000000000000000000000000000000000000000000000000001
10000011000X000000000000000000000000000000000000000000000000000000000000000000000000000000000000000000000000000000001
1000C0110000000000000000000000000000000000000000000000000000000000000000000000000000000000000000000000000000000000001
10000011000C000000000000000000000000000000000000000000000000000000000000000000000000000000000000000000000000000000001
10000011000C000000000000000000000000000000000000000000000000000000000000000000000000000000000000000000000000000000001
100C0011000C000000000000000000000000000000000000000000000000000000000000000000000000000000000000000000000000000000001
100000110000000000000000000000000000000000000000000000000000000000000000000000000000000000000000000000000000000000001
100000110000000000000000000000000000000000000000000000000000000000000000000000000000000000000000000000000000000000001
100C00110000000000000000000000000000000000000000000000000000000000000000000000000000000000000000000000000000000000001
100000110000000000000000000000000000000000000000000000000000000000000000000000000000000000000000000000000000000000001
100000110000000000000000000000000000000000000000000000000000000000000000000000000000000000000000000000000000000000001
100000110000000000000000000000000000000000000000000000000000000000000000000000000000000000000000000000000000000000001
1000C0110000000000000000000000000000000000000000000000000000000000000000000000000000000000000000000000000000000000001
100000110000000000000000000000000000000000000000000000000000000000000000000000000000000000000000000000000000000000001
100000000000000000000000000000000000000000000000000000000000000000000000000000000000000000000000000000000000000000001
100000000000000000000000000000000000000000000000000000000000000000000000000000000000000000000000000000000000000000001
100000000000000000000000000000000000000000000000000000000000000000000000000000000000000000000000000000000000000000001
100000000000000000000000000000000000000000000000000000000000000000000000000000000000000000000000000000000000000000001
100000000000000000000000000000000000000000000000000000000000000000000000000000000000000000000000000000000000000000001
100000000000000000000000000000000000000000000000000000000000000000000000000000000000000000000000000000000000000000001
100000000000000000000000000000000000000000000000000000000000000000000000000000000000000000000000000000000000000000001
100000000000000000000000000000000000000000000000000000000000000000000000000000000000000000000000000000000000000000001
100000000000000000000000000000000000000000000000000000000000000000000000000000000000000000000000000000000000000000001
100000000000000000000000000000000000000000000000000000000000000000000000000000000000000000000000000000000000000000001
100000000000000000000000000000000000000000000000000000000000000000000000000000000000000000000000000000000000000000001
100000000000000000000000000000000000000000000000000000000000000000000000000000000000000000000000000000000000000000001
100000000000000000000000000000000000000000000000000000000000000000000000000000000000000000000000000000000000000000001
100000000000000000000000000000000000000000000000000000000000000000000000000000000000000000000000000000000000000000001
100000000000000000000000000000000000000000000000000000000000000000000000000000000000000000000000000000000000000000001
100000000000000000000000000000000000000000000000000000000000000000000000000000000000000000000000000000000000000000001
100000000000000000000000000000000000000000000000000000000000000000000000000000000000000000000000000000000000000000001
100000000000000000000000000000000000000000000000000000000000000000000000000000000000000000000000000000000000000000001
100000000000000000000000000000000000000000000000000000000000000000000000000000000000000000000000000000000000000000001
111111111111111111111111111111111111111111111111111111111111111111111111111111111111111111111111111111111111111111111
