11111111111111111111111111111111111111111111111111111
1EPC0000000000000000111111110000000000000000000000001
100C0000000000000000111111110000000000000000000000001
10000000000000000000111000111110000000000000000000001
10000000000000000000111000111110000000000000000000001
10CCCCCC000000000001110000001110000000000000000000001
10C00000000000000001110000001110000000000000000000001
10C00X00000000000001100000111011100000000000000000001
10C00000000000000001100000111011100000000000000000001
10C00000000000000111111111100000110000000000000000001
10C00000000000000111111111100000110000000000000000001
10000000000000011110000000000000111110000000000000001
10000000000000011110000000000000111110000000000000001
10000X00000001111000000000000111101111100000000000001
10000000000001111000000000000111101111100000000000001
100X0000000001100011100001111101111001110000000000001
10000000000001100011100001111101111001110000000000001
10000000000001111111111111100111111111110000000000001
10000000000001111111111111100111111111110000000000001
10000000001111111111111110001101111111111110000000001
10000000001111111111111110001101111111111110000000001
10000000011100110111110110001101111101100111000000001
10000000011100110111110110001101111101100111000000001
10000000011000110111110110111101111101100011000000001
10000000011000011111111111100111111111000011000000001
10000000011000011111111111100111111111000011000000001
10000011111111111111111000000011111100001111110000001
10000011111111111111111000000011111100001111110000001
10000111100000000011111111111111111100011100011110001
10000111100000000011111111111111111100011100011110001
10001110000000000001111000000011111111111000000011001
10001110000000000001111000000011111111111000000011001
10001100000000000000011111111111111100000000001100001
10001100000000000000011111111111111100000000001100001
10001110000000000000011111111110000000000000111100001
10001110000000000000011111111110000000000000111100001
10000111111111111111111111111111111111111111111000001
1000X000000000000000000000000000000000000000000000001
11111111111111111111111111111111111111111111111111111
