111111111111
1E1PC0000001
1E1PC0000001
1E1PC0000001
1E1PC0000001
1E1PC0000001
111111111111
