111111111111
1E1PC0000001
100000000001
100000000001
100D00000011
100D000001C1
111111111111
