111111111111
1E1P00000001
1000000000C1
1000000000C1
1000000000C1
111111111111
