1111111111111
1E1000010P011
10101C0100011
10101D0100011
1010100100011
1000100001011
1111111111111
