111111111111
1E1PC0000001
100000000001
100000000001
100000000011
1000000001C1
111111111111
