11111
1EPC1
1CCC1
1CCC1
1CCC1
1CEC1
1CCC1
11111
