111111111111
1E1PC0000001
100000000001
100000000001
1000000000X1
100000000XC1
111111111111
