1111111111111111
1E100000000000P1
1010000000000001
1010000000000001
1010000010000001
1010000010000C01
1000000010000001
1111111111111111
