11111111111111111111111111111111111111111111111111111
1E0C0000000000000000111111110000000000000000000000001
100C00000000000000001111111100000000000P0000000000001
10000000000000000000111000111110000000000000000000001
10000000000000000000111000111110000000000000000000001
10000000000000000001110000001110000000000000000000001
10000000000000000000000000000000000000000000000000001
11111111111111111111111111111111111111111111111111111
