1111111111111111
1010000000000001
1010000000000001
1010000000000001
1010000000000001
1010000000000CP1
10000000000000E1
1111111111111111
