11111111111111111111111111111111111111111111111111111
1EPC0000000000000000111111110000000000000000000000001
1EPC0000000000000000111111110000000000000000000000001
10000000000000000000111000111110000000000000000000001
10000000000000000000111000111110000000000000000000001
10000000000000000000111000111110000000000000000000001
10000000000000000000111000111110000000000000000000001
10000000000000000000111000111110000000000000000000001
11111111111111111111111111111111111111111111111111111
