1111111111111111
1E100000000000P1
10100C000X000001
10100C0000000001
1010000011C11111
1010000010000C01
1000000010000001
1111111111111111
